1 Tuesday	write[queue]-SK[JN,HS] edit-WJG[IM,AM]
1 Wednesday	write-RG edit-PG
1 Thursday	write-GFA edit-CJ
1 Friday	write-GD edit-MH
1 Saturday	write-WY edit-AG
1 Sunday	open	 edit-
2 Monday	write[queue]-Lzal[SW,KG] edit-LA[DG,RH]
2 Tuesday	write-Lzag edit-CC
2 Wednesday	write-AW edit-LL
2 Thursday	write-APic edit-KP
2 Friday	write(beyond)-SN edit-PH
2 Saturday	write-JSt edit-APiz
2 Sunday	open	 edit-
3 Monday	write-AAS edit-AAS
3 Tuesday	write-AAS edit-AAS
3 Wednesday	write-AAS edit-AAS
3 Thursday	write-JH edit-OC
3 Friday	write-VK edit-JS
3 Saturday	write-ZS edit-CM
3 Sunday	open	 edit-
4 Monday	write[queue]-WJG[MH,ACu] edit-SK[JN,SS]
4 Tuesday	write-IM edit-RG
4 Wednesday	write-PG edit-GFA
4 Thursday	write-CJ edit-GD
4 Friday	write-AG edit-WY
4 Saturday	write(beyond)-LA edit-LZal
4 Sunday	open	 edit-
5 Monday	write[queue]-DG[AC] edit-Lzag[SW]
5 Tuesday	write-LL edit-AW
5 Wednesday	write-KP edit-APic
5 Thursday	write-PH edit-MC
5 Friday	write-APiz edit-JSt
5 Saturday	write-SS edit-ACu
5 Sunday	open	 edit-
6 Monday	write[queue]-RH[AM,CC] edit-HS[ZS,SN]
6 Tuesday	write-CM edit-KG
6 Wednesday	write-OC edit-JH
6 Thursday	write-JS edit-VK
6 Friday	write(beyond)-MC edit-AC
6 Saturday	write-LA edit-ACu
6 Sunday	open	 edit-
7 Monday	write[queue]-AG[LZal] edit-CC[VK]
7 Tuesday	write-WY edit-KG
7 Wednesday	write-HS edit-AM
7 Thursday	write-Acu edit-RH
7 Friday	write-MH edit-SN
7 Saturday	write-ZS edit-PG
7 Sunday	open	 edit-
8 Monday	write[queue]-KP[OC] edit-Apiz[JN]
8 Tuesday	write-JS edit-GFA
8 Wednesday	write-AW edit-JH
8 Thursday	write-GD edit-AC
8 Friday	write(beyond)-WJG edit-LZag
8 Saturday	write-JSt edit-CM
8 Sunday	open	 edit-
9 Monday	write[queue]-LL[RG] edit-PH[IM]
9 Tuesday	write-DG edit-APic
9 Wednesday	write-CJ edit-SS
9 Thursday	write-SW edit-SK
9 Friday	write-MC edit-ZS
9 Saturday	write-CC edit-AG
9 Sunday	open	 edit-
10 Monday	write[queue]-VK[AM] edit-Lzal[WY]
10 Tuesday	write-KG edit-HS
10 Wednesday	write-RH edit-MC
10 Thursday	write-SN edit-MH
10 Friday	write(beyond)-PG edit-LA
10 Saturday	write-APiz edit-KP
10 Sunday	open	 edit-
11 Monday	write[queue]-JN[GFA] edit-OC[JS]
11 Tuesday	write-JH edit-AW
11 Wednesday	write-AC edit-GD
11 Thursday	write-LZag edit-WJG
11 Friday	write-CM edit-CJ
11 Saturday	write-PH edit-SW
11 Sunday	open	 edit-
12 Monday	write[queue]-IM[APic] edit-RG[DG]
12 Tuesday	write-SS edit-JSt
12 Wednesday	write-SK edit-LL
12 Thursday	write-CJ edit-AG
12 Friday	write(beyond)-SW edit-JN
12 Saturday	write-AM edit-CC
12 Sunday	open	 edit-
13 Monday	write[queue]-WY[PG] edit-Lzal[VK]
13 Tuesday	write-KG edit-OC
13 Wednesday	write-GD edit-JSt
13 Thursday	write-DG edit-JS
13 Friday	write-ZS edit-AC
13 Saturday	write-PH edit-AW
13 Sunday	open	 edit-
14 Monday	write[queue]-LA[CM] edit-HS[SK]
14 Tuesday	write-ACu edit-GFA
14 Wednesday	write-MC edit-RG
14 Thursday	write-KP edit-LL
14 Friday	write(beyond)-WJG edit-MH
14 Saturday	write-SS edit-JH
14 Sunday	open	 edit-
15 Monday	write[queue]-Apiz[LZag] edit-RH[SN]
15 Tuesday	write-IM edit-Apic
15 Wednesday	write-AG edit-CJ
15 Thursday	write-JSt edit-SW
15 Friday	write-CC edit-AM
15 Saturday	write-LZal edit-WY
15 Sunday	open	 edit-
16 Monday	write[queue]-VK[OC] edit-KG[PG]
16 Tuesday	write-JN edit-GD
16 Wednesday	write-JS edit-DG
16 Thursday	write-AC edit-IM
16 Friday	write(beyond)-AW edit-PH
16 Saturday	write-HS edit-LA
16 Sunday	open	 edit-
17 Monday	write[queue]-SK[GFA] edit-CM[ACu]
17 Tuesday	write-RG edit-MC
17 Wednesday	write-LL edit-KP
17 Thursday	write-MH edit-WJG
17 Friday	write-JH edit-SS
17 Saturday	write-RH edit-APiz
17 Sunday	open	 edit-
18 Monday	write[queue]-SN[APic] edit-ZS[LZag]